p r r r r r r r r r r r r r r r r r r r
r w w w w w w w w w r w w w w w w w w r
r w r r r w r r r w r d r r r w r r w r
r w r r r d r r r w r w r r r w r r w r
r w r r r w w w d w r w r r r d r r w r
r w r r r w r r r w r w r r r w r r w r
r w d w w w w w w w r w w w w w w w w r
r r r r r r r r r r r r r r r r r r r r
r w w w w w w w w r w w d w w w w w w r
r w r r w r r r w r w r r r d r r r w r
r w r r w r r r d r w r r r w r r r w r
r w r r d r r r w r w r r r w w w d w r
r w r r w r r r w r w r r r w r r r w r
r w w w w w w w w r w w w w w w w w w r
r r r r r r r r r r r r r r r r r r r r 

w w w w w w w w w w w w w w w w w w w w
w p r r r r r r r r r r r r r r r r r w 
w r w d w r w w r w w r w w w w r r r w 
w r r r w r w r r w r r w r r w r r r w 
w r r r w r w r r w r r w r r w r r r w 
w r r r w r w w w w r r w r r w r r r w 
w w w w w r r r r w w w w r w w r r r w 
w r r r w r w w d w w r r r r r r r r w 
w r r r w r w r r r w r w w w w r w r w 
w r r r r r w r r r w r w r r r r w r w 
w r r r w r w r r r r r w r r r r w r w 
w r r r w r w r r r w r w r r r r w r w 
w w w w w r w w w w w w w w w w w w r w 
w r r r r r r r r r r r r r r r r r r w 
w w w w w w w w w w w w w w w w w w w w 



